**********
*****    B
***** ****
***   ****
*** ******
          
 * *** ***
 * *** ***
A* *** ***
**********