**********
** ** * B*
** ** * **
**       *
**     ***
*** ******
*** ******
*    A****
* ********
**********