**********
*****    B
* *** ****
* *   ** *
* * **** *
*         
*** *** **
***     **
***A******
**********