**********
***** * B*
***** * **
**       *
**     ***
*** ******
*** ******
*    A****
* ********
**********